##########
##########
#...##...#
#........#
##########
..........
..........
..........
..........
..........