##########
##......##
#...##...#
#..#..#..#
##########
..........
..........
..........
..........
..........
