##########
#####...##
######...#
#####.#..#
##########
..........
..........
..........
..........
..........
