##########
##..##..##
#...##...#
##########
##########
..........
..........
..........
..........
..........