####..####
####....##
####.....#
####..#..#
####..####
..........
..........
..........
..........
..........
