##########
##########
#..####..#
#..####..#
##########
..........
..........
..........
..........
..........